1111111111
1000000001
100C0P0001
10000001E1
1000000001
10000001C1
1111111111
